NO textures/level1_1.xpm
SO textures/level1_1.xpm
EA textures/level1_2.xpm
WE textures/level1_2.xpm
F 0,51,102
C 0,0,0


111111111111111111111111111111
100100000000000000000001000001
101001111111100000000001000001
1100E0000000111000000000000001
110111000000000000001100000001
100111111111111111111111111111
1011
111