NO textures/level8_1.xpm
SO textures/level8_1.xpm
EA textures/level8_2.xpm
WE textures/level8_2.xpm
F 97,0,11
C 133,0,15


1111111111111111111
1001000000S00000001
1000000000000000001
1100000000000000001
110111000000D000001
1000000000000000001
1011000000111111111
1000000000000001001
1000011110000001001
1000000000000000001
1111111111111111111

