NO textures/nightclub.xpm
SO textures/nightclub.xpm
EA textures/nightclub.xpm
WE textures/nightclub.xpm
F 0,51,102
C 0,0,0


11111111111111111111111
10010000000000000000001
10100100000000000000001
11000000E00000000000001
11011100000000000000001
11111111111111111111111