NO textures/nightclub.xpm
SO textures/nightclub.xpm
EA textures/nightclub.xpm
WE textures/nightclub.xpm
F 0,51,102
C 0,0,0



         1111111111111 
1111111110000000000001
1000E000D0000000000001
1111111110000000000001
        11111111111111