NO textures/brick.xpm   
SO textures/colorstone.xpm
WE textures/grass.xpm
EA textures/metal.xpm
F 0,255,0
C 225,30,0


111111111111111111111111111111
100100000000000000000000000001
101001000000000000000000000001
1100N0000000000000000000000001
111111000000000000000000000001
111111111111111111111111111111
101
111


