NO textures/brick.xpm   
SO textures/colorstone.xpm
WE textures/grass.xpm
EA textures/metal.xpm
F 92,215,31
C 54,189,255


111111111111111111111111111111
100100000000000000000000000001
101001000000000000000000000001
1100N0000000000000000000000001
110111000000000000000000000001
100111111111111111111111111111
1011
111


