NO textures/brick.xpm   
SO textures/colorstone.xpm
WE textures/grass.xpm
EA textures/metal.xpm
F 0,255,0
C 225,30,0


111111
100101
101001
1100N1
111111
111
101
111


