NO textures/slide6.xpm
SO textures/optical-illusion2.xpm
EA textures/colorstone.xpm
WE textures/wall_texture.xpm   
F 92,215,31
C 0,0,255


111111111111111111111111111111
100100000000000000000000000001
101001000000000000000000000001
1100E0000000000000000000000001
110111000000000000000000000001
100111111111111111111111111111
1011
111


