NO textures/brick.xpm
SO textures/brick.xpm
WE textures/brick.xpm
EA textures/brick.xpm
F 153,76,0
C 204,229,255


111
111
          11111
          11111
